13
15
8 8 8 8 8 8 8 8 8 8 8 8 8 8 8
8 1 0 0 6 0 6 0 6 0 6 0 0 7 8
8 6 8 0 8 0 8 0 8 0 8 0 8 0 8
8 0 0 6 0 6 6 0 6 0 6 6 0 0 8
8 0 8 0 8 0 8 6 8 0 8 0 8 0 8
8 0 0 6 0 6 0 6 6 0 0 6 0 6 8
8 6 8 0 8 0 8 0 8 0 8 0 8 0 8
8 0 0 0 6 6 0 0 6 0 6 0 0 0 8
8 6 8 0 8 0 8 0 8 0 8 0 8 6 8
8 0 0 6 0 0 6 0 0 6 0 6 0 0 8
8 0 8 0 8 6 8 6 8 0 8 0 8 0 8
8 7 0 6 6 0 6 0 6 6 0 6 0 0 8
8 8 8 8 8 8 8 8 8 8 8 8 8 8 8

